 1                        2

WWWWWWWWWWWWWWWWWWWWWWWWWWWW
WPPPPPPPPPPPPWWPPPPPPPPPPPPW
WPWWWWPWWWWWPWWPWWWWWPWWWWPW
W@WWWWPWWWWWPWWPWWWWWPWWWW@W
WPWWWWPWWWWWPWWPWWWWWPWWWWPW
WPPPPPPPPPPPPPPPPPPPPPPPPPPW
WPWWWWPWWPWWWWWWWWPWWPWWWWPW
WPWWWWPWWPWWWWWWWWPWWPWWWWPW
WPPPPPPWWPPPPWWPPPPWWPPPPPPW
WWWWWWPWWWWWPWWPWWWWWPWWWWWW
     WPWWWWW WW WWWWWPW
     WPWW          WWPW
     WPWW WWW  WWW WWPW
WWWWWWPWW W      W WWPWWWWWW
      P   W      W   P
WWWWWWPWW W      W WWPWWWWWW
     WPWW WWWWWWWW WWPW
     WPWW          WWPW
     WPWW WWWWWWWW WWPW
WWWWWWPWW WWWWWWWW WWPWWWWWW
WPPPPPPPPPPPPWWPPPPPPPPPPPPW
WPWWWWPWWWWWPWWPWWWWWPWWWWPW
WPWWWWPWWWWWPWWPWWWWWPWWWWPW
W@PPWWPPPPPPPPPPPPPPPPWWPP@W
WWWPWWPWWPWWWWWWWWPWWPWWPWWW
WWWPWWPWWPWWWWWWWWPWWPWWPWWW
WPPPPPPWWPPPPWWPPPPWWPPPPPPW
WPWWWWWWWWWWPWWPWWWWWWWWWWPW
WPWWWWWWWWWWPWWPWWWWWWWWWWPW
WPPPPPPPPPPPPPPPPPPPPPPPPPPW
WWWWWWWWWWWWWWWWWWWWWWWWWWWW

3                          4